30x20
-1 -1 -1 -1 -1 -1 -1 -1 -1 -1 -1 -1 -1 -1 -1 -1 -1 -1 -1 -1 -1 -1 -1 -1 -1 -1 -1 -1 -1 -1
-1 -1 -1 -1 -1 -1 -1 -1 -1 -1 -1 -1 -1 -1 -1 -1 -1 -1 -1 -1 -1 -1 -1 -1 -1 -1 -1 -1 -1 -1
-1 -1 -1 -1 -1 -1 -1 -1 -1 -1 -1 -1 -1 -1 -1 -1 -1 -1 -1 -1 -1 -1 -1 -1 -1 -1 -1 -1 -1 -1
-1 -1 -1 -1 -1 -1 -1 -1 -1 -1 -1 -1 -1 -1 -1 -1 -1 -1 -1 -1 -1 -1 -1 -1 -1 -1 -1 -1 -1 -1
-1 -1 -1 -1 -1 -1 -1 -1 -1 -1 -1 -1 -1 -1 -1 -1 -1 -1 -1 -1 -1 -1 -1 -1 -1 -1 -1 -1 -1 -1
-1 -1 -1 -1 -1 -1 -1 -1 -1 -1 -1 -1 -1 -1 -1 -1 -1 -1 -1 -1 -1 -1 -1 -1 -1 626 -1 -1 -1 -1
-1 -1 -1 -1 -1 -1 -1 -1 -1 -1 -1 -1 -1 -1 -1 -1 -1 -1 -1 -1 -1 -1 -1 -1 628 652 -1 -1 -1 -1
-1 -1 2881 2882 2883 2884 2885 2886 2887 -1 -1 -1 -1 -1 -1 -1 -1 -1 -1 -1 -1 -1 -1 -1 654 -1 -1 -1 -1 -1
-1 -1 2911 2912 2913 2914 2915 2916 2917 -1 -1 -1 1102 1103 1104 1105 -1 -1 -1 -1 -1 -1 -1 -1 -1 -1 -1 -1 -1 759
-1 -1 2941 2942 2943 2944 2945 2946 2947 -1 -1 -1 1126 1127 1128 1129 -1 -1 -1 -1 -1 -1 -1 -1 -1 756 -1 -1 -1 785
-1 -1 2971 2972 2973 2974 2975 2976 2977 -1 -1 -1 1150 1151 1152 1153 -1 -1 -1 -1 -1 -1 -1 -1 -1 782 -1 -1 -1 -1
-1 -1 -1 -1 -1 -1 -1 -1 -1 -1 -1 -1 1174 1175 1176 1177 -1 -1 -1 -1 -1 -1 -1 -1 -1 -1 -1 -1 -1 -1
1262 1263 1264 1265 -1 -1 -1 -1 -1 -1 -1 -1 1198 1199 1200 1201 -1 -1 -1 -1 -1 1266 1267 1268 1269 -1 -1 -1 -1 -1
1286 1287 1288 1289 -1 -1 -1 -1 -1 -1 -1 -1 1222 1223 1224 1225 -1 -1 -1 -1 -1 1290 1291 1292 1293 -1 -1 -1 -1 -1
1310 1311 1312 1313 -1 -1 -1 -1 -1 -1 -1 -1 -1 -1 -1 -1 -1 -1 -1 -1 -1 1314 1315 1316 1317 -1 -1 -1 -1 -1
1334 1335 1336 1337 -1 -1 -1 -1 -1 -1 -1 -1 -1 -1 -1 -1 -1 -1 -1 -1 -1 1338 1339 1340 1341 -1 -1 -1 -1 -1
1358 1359 1360 1961 -1 -1 -1 -1 -1 -1 -1 -1 -1 -1 -1 -1 -1 -1 -1 -1 -1 1362 1363 1364 1365 -1 -1 -1 -1 -1
1382 1383 1384 1385 -1 -1 -1 -1 -1 -1 -1 -1 -1 -1 -1 -1 -1 -1 -1 -1 -1 1386 1387 1388 1389 -1 -1 -1 -1 -1
-1 -1 -1 -1 -1 -1 -1 -1 -1 -1 -1 -1 -1 -1 -1 -1 -1 -1 -1 -1 -1 -1 -1 -1 -1 -1 -1 -1 -1 -1
-1 -1 -1 -1 -1 -1 -1 -1 -1 -1 -1 -1 -1 -1 -1 -1 -1 -1 -1 -1 -1 -1 -1 -1 -1 -1 -1 -1 -1 -1
