30x20
-1 -1 -1 -1 -1 -1 -1 -1 -1 -1 -1 60 61 62 63 64 -1 -1 -1 -1 -1 -1 1262 1263 1264 1265 -1 -1 -1 -1
-1 -1 -1 -1 -1 -1 -1 -1 -1 -1 -1 72 73 74 75 76 -1 -1 -1 -1 -1 -1 1286 1287 1288 1289 -1 -1 -1 -1
-1 -1 -1 -1 -1 -1 -1 -1 1961 -1 -1 84 85 86 87 88 -1 -1 -1 -1 -1 -1 1310 1311 1312 1313 -1 -1 -1 -1
-1 -1 -1 -1 -1 -1 -1 -1 -1 -1 -1 96 97 98 99 100 -1 -1 -1 -1 1902 -1 1334 1335 1336 1337 -1 -1 -1 -1
-1 -1 -1 -1 526 527 528 -1 -1 -1 -1 -1 -1 -1 -1 -1 -1 -1 -1 1361 -1 -1 1358 1359 1360 1361 -1 -1 -1 -1
-1 -1 -1 -1 552 553 554 -1 -1 -1 -1 -1 -1 -1 -1 -1 1382 -1 -1 1385 -1 -1 1382 1383 1384 1385 -1 -1 -1 -1
-1 -1 -1 -1 578 579 580 -1 -1 -1 -1 -1 -1 -1 -1 -1 -1 -1 -1 -1 -1 -1 -1 1902 -1 -1 682 683 684 -1
2652 2653 -1 -1 604 605 606 -1 -1 -1 -1 -1 -1 -1 -1 -1 -1 -1 -1 -1 2516 2517 -1 -1 -1 -1 734 735 736 1273
2682 2683 -1 -1 604 605 606 -1 2652 2653 -1 -1 1102 1103 1104 1105 -1 -1 -1 -1 2546 2547 -1 -1 -1 -1 760 761 762 -1
-1 -1 -1 -1 552 553 554 -1 2682 2683 -1 -1 1126 1127 1128 1129 2636 2637 -1 -1 -1 -1 -1 -1 -1 -1 708 709 710 -1
-1 -1 -1 -1 578 579 580 -1 -1 -1 -1 -1 1150 1151 1152 1153 2666 2667 -1 -1 -1 1362 -1 -1 1365 -1 734 735 736 -1
-1 -1 -1 -1 604 605 606 -1 -1 -1 -1 -1 1174 1175 1176 1177 -1 -1 -1 -1 -1 1386 -1 -1 1389 -1 760 761 762 1369
1262 1263 1264 1265 630 631 632 -1 -1 1958 -1 -1 1198 1199 1200 1201 -1 -1 -1 -1 -1 1266 1267 1268 1269 -1 786 787 788 1393
1286 1287 1288 1289 -1 -1 -1 -1 -1 -1 1896 1897 1222 1223 1224 1225 -1 -1 -1 -1 -1 1290 1291 1292 1293 -1 -1 -1 -1 -1
1310 1311 1312 1313 -1 -1 -1 -1 -1 -1 1926 1927 -1 -1 -1 -1 -1 -1 -1 -1 -1 1314 1315 1316 1317 -1 -1 -1 -1 -1
1334 1335 1336 1337 -1 -1 -1 -1 -1 -1 -1 -1 -1 -1 -1 -1 -1 -1 -1 -1 -1 1338 1339 1340 1341 -1 -1 -1 -1 -1
1358 1359 1360 1961 -1 -1 -1 -1 -1 -1 -1 -1 -1 -1 -1 -1 -1 -1 -1 -1 -1 1362 1363 1364 1365 -1 -1 -1 -1 -1
1382 1383 1384 1385 -1 -1 -1 -1 -1 -1 -1 -1 -1 -1 -1 -1 -1 -1 -1 -1 -1 1386 1387 1388 1389 -1 -1 -1 -1 -1
-1 -1 -1 -1 -1 -1 -1 -1 -1 -1 -1 2114 -1 -1 -1 -1 -1 -1 -1 -1 -1 -1 -1 -1 -1 -1 -1 -1 -1 -1
-1 -1 -1 -1 -1 -1 -1 -1 -1 -1 -1 -1 -1 -1 -1 -1 -1 -1 -1 -1 -1 -1 -1 -1 -1 -1 -1 -1 -1 -1
